WE	./textures/bluestone.xpm
NO	./textures/orange_brick.xpm
F   5,   40,     5
EA	./textures/purplestone.xpm
SO	./textures/greystone.xpm
C   10, 120 , 255

          
11111111111111111111111111111111111111111111111111111111111111111111111111111111111111111111111111111111111111111111111111111111111111111111111
111111111111111111111111111111111111111111111111111111111111111111111111111111111111111111111111111111111111111111111111111111111111
11111111111111111111111111111111111111111111111111111111111111111111111111111111111111111111111111111111111111111111111111111111111111111111111
10000000000000000000000000000000000000000000000000000000000000000000000000000000000000000000000000000000000000000000000000000000000000000000001
10000000000000000000000000000000000000000000000000000000000000000000000000000000000000000000000000000000000000000000000000000000000000000000001
10000000000000000000000000000000000000000000000000000000000000000000000000000000000000000000000000000000000000000000000000000000000000000000001
10000000000000000000000000000000000000000000000000000000000000000000000000000000000000000000000000000000000000000000000000000000000000000000001
10000000000000000000000000000000000000000000000000000000000000000000000000000000000000000000000000000000000000000000000000000000000000000000001
10000000000000000000000000000000000111111111100000000000000000000000000000000000000000000000000000000000000000000000000000000000000000000111111
10000000000000000000000000000000000000000000000000000000000000000000000000000000000000000000000000000000000000000000000000000000000000000000001
10000000000000000000000000000000000000000000000000000000000000000000001110000000000000000000000000000000000000000000000000000000000000000000001
10000000000000000000000000000000000000000000000000000000000000000000000000000000000000000000000000000000000000000000000000000000000000000000001     
10000000000110000000000000000000000000011100000000000000000000000000000000000000000000000000000000000000000000000000000000000000000000000000001
100000000001100000000000000000000000000000000000000000000000000000000000000000000000000000000000000000000000000000000000000000000000000000000001
10000000000000000000000000000000000000000000000000000000111110000000000000000000000000000000000000000000000000000000000000000000000000000000001
100000000000000000000000000000000000000E000000000000000011111000000000000000000111111111111111111111111111111111111111111111111111111111111111111
10000000000000000000000000000000000000000000000000000000000000000000000000000000000000000000000000000000000000000000000000000000000000000000001
10000000000000000000000000000000000000000000000000000000000000000000000000000000000000000000000000000000000000000000000000000000000000000000001
10000000000000000011111110000000000000000000000000000000000000000000000000000000000000000000000000000000000000000000000000000000000000000000001
1000000000000000001     100000000000000000000000000000000000000000000000000000000000000000000000000000000000000000000000000000000000000000000011111111111111111111111
100000000000000000111111100000000000000000000000000000000000000000000000000000000000000000000000000000000000000000000000000000000000000000000000000000000000000000001
100000000000000000000000000000000000000000000000000000001111100000000000000000011111111111111111111111111111111111111111111111111111111111111111111111111111111111101
1000000000000000000000000000000000000000000000000000000011111000000000000000000111111111111111111111111111111111111111111111111111111111111111111                 101
1000000000000000000000000000000000000000000000000000000011111000000000000000000111111111111111111111111111111111111111111111111111111111111111111                 101
1000000000000000000000000000000000000000000000000000000011111000000000000000000111111111111111111111111111111111111111111111111111111111111111111                 101
1000000000000000000000000000000000000000000000000000000011111000000000000000000111111111111111111111111111111111111111111111111111111111111111111                 101
1000000000000000000000000000000000000000000000000000000011111000000000000000000111111111111111111111111111111111111111111111111111111111111111111              111101111111111
1000000000000000000000000000000000000000000000000000000011111000000000000000000111111111111111111111111111111111111111111111111111111111111111111              11110000000011111
10000000000000000000000000000000000000000000000000000000111110000000000000000001111111111111111111111111111111111111111111111111111111111111111111111     111111111100000111111
1000000000000000000000000000000000000000000000000000000011111000000000000000000111111111111111111111111111111111111111111111111111111111111111111                111111111111
1000000000000000000000000000000000000000000000000000000011111000000000000000000111111111111111111111111111111111111111111111111111111111111111111
1000000000000000000000000000000000000000000000000000000011111000000000000000000111111111111111111111111111111111111111111111111111111111111111111
1000000000000000000000000000000000000000000000000000000011111000000000000000000111111111111111111111111111111111111111111111111111111111111111111      11111111111
1000000000000000000000000000000000000000000000000000000011111000000000000000000111111111111111111111111111111111111111111111111111111111111111111      11100000011
1000000000000000000000000000000000000000000000000000000011111000000000000000000111111111111111111111111111111111111111111111111111111111111111111      11110000001
1000000000000000000000000000000000000000000000000000000011111000000000000000000111111111111111111111111111111111111111111111111111111111111111111      11100000111
1000000000000000000000000000000000000000000000000000000011111000000000000000000111111111111111111111111111111111111111111111111111111111111111111      11100000011
1000000000000000000000000000000000000000000000000000000011111000000000000000000111111111111111111111111111111111111111111111111111111111111111111      10000000011
1000000000000000000000000000000000000000000000000000000011111000000000000000000111111111111111111111111111111111111111111111111111111111111111111       111110111
1000000000000000000000000000000000000000000000000000000011111000000000000000000111111111111111111111111111111111111111111111111111111111111111111           10111
111111111111111111111111111111111111111111111111111111111111111111111111111111111111111111111111111111111111111111111111111111111111111111111111111111111    1     